sg1_fwd	sg2_fwd	id
GGCGAGCAGGAGGACAACAA	CACAGGTGTAGTTGGTCTGT	Acvr1b
GCGGAGCCAGACAGCGCCAG	CAGTAAAGTTGAACCAGACT	Agbl4
AGTGGTCATAGAACTCGCCC	AATGTACGGACGCTGCCATG	Ano10
AAGAGGCCGAAGGCGCCCGA	GGTACCTGGAATTATCTAAT	Ap3b1
GGAGAAGATCCTAGCTGACA	CCTGCCAATCCAAGTCACCT	Arfgef2
CGCAAGGCTCCTGTGAGCCG	AAGGCTATCAGACAGACGTT	Ascc3
CTTGGATGGATCCACGTCGC	CCTCGCTGAAATATCGTGTA	Astn1
GCTCTGCGGGAAAGCGACAT	TCCGAGGGCTCCTGGAGTGT	Astn2
CGCTCACACAAAGACCGTGG	CTCAATCACAAGTTCCAGCA	Atp2a2
CGTGGCTCACGTATGTGCAC	GCAGGAAGACGTATTCGGAT	B4galnt4
GAAGGAGCAGAAGATGATGT	AAGGGTCGCCCTCCCAATGT	Baz2b
TCTTCTAATTGAGTGATACT	ATGTCCGTAAGAAGTTACGG	Bltp1
GGAGGAGCTATGCACACCAG	GTTGGGCATGCAGCTGACAT	Ccser1
TTCCTCTTAGAAGAGTATAC	CAGGAACACTGGCTGTGTAC	Cdh9
AGGAAATGAGAGTTGTTGAC	GCAGAGAACCAGCTACTCGC	Chmp3
GGCACACACCCAGCGAGCGT	TGTGCAGCGAGTGAACAATG	Cnnm2
TGTGGAATGCCCTCTTTGCA	GAAAGTGGTTTGTAAACTGC	Cnot4
AGCCGGCGGTCCCTGCGCGT	TGACAGTTTGAGTGAGATCT	Cntln
TCCGGTAGAGCTAGGCGCTC	CAGACAGTGGTACTCCCTCA	Cstpp1
GCCCGACTTGTCCCGCACCC	ATGCTCCTTAGCGTGATGGA	Cttnbp2
TGCCCACAGACCAGCGCCGC	CACGTAGAGCACGTACTGCA	Dagla
GAAGTGGCTTATCCTAGGAC	GGTGCAGAGGCAATTCCCAG	Dennd1a
ACCAAGTCAAAAGTTCTTTC	AAATACTCTGGCAGATTACT	Dennd1b
GAGGAAGGTAGTTGACTATT	AAAGCTATCAACACTCTGAA	Elavl2
GGAGGGTCCATTGCTTGTAT	TGTTAACTATATTGATCCAA	Elavl4
GGAGCCTTCTGATGGCAGCG	GTCCCGGTTGTGCTCGATGC	Erbb4
AGTCCAGCGGAAGCAATGTT	GATGACAGTCTGGAGAGCCT	Erc2
ACTGTAACTCCCACTGGCGT	ACCATGAATGGCCATCAGAA	Esrrg
TGACCAGCAAGTGCCTTACG	CAGACCCGAGTTCTGAACAT	Etv1
TCGGTAGCGGAAATCCTCTT	TTCTGATGCAGGAGGACCTC	Etv6
ACCGAGATGAGCAGCCCCGA	GCTGAACGATCAATTCATCC	Exoc4
GAAGGCCCGGCTGCACGAGT	AAGCCAGTATCTGATGCACG	Fam120a
CCGCTTGCAAACCATCTCGA	TGTATATCCTCTGTAACTTC	Fbxl17
TGCAACCAAATGCAAGACGT	AACTGAACTGTCCTTCGCCC	Fhit
TTAAGCAGCCAATTAGATGC	GTCTCCAGGTTCAAGCAAAC	Foxp2
GGGTCTCTCTGACTATCTTT	TATGACAATCGTCTGAGACC	Gabra1
ATCGCCTACTACATGTACTC	AGAGGAGATGAGAAAGCACA	Galnt2
GAAACACAGACACTAAACTT	TGATGAGCGTGGTTACCGAA	Gigyf2
GCTCCAATAATAATGTCACC	AAGTCATTTACCTAAAGCCC	Grm5
AGCGGTTCCTCTGCCGGACC	TTGTTAGACAATGATTCACA	Htt
ACAGATAGTTCTGCACCCGC	AAATCAAGCAACCAAACACA	Kcnq5
AGAGGAAGAGCAAATCCAGC	ATGCTGGGAAGTACGTGTGC	Kirrel3
GCTGCTATCACATAGCACCC	TTCCCAGGGATATGAGCACG	Lhpp
ACAATCAGCACCTCAGCGTT	CTGTGTCCCTGACCAATTAG	Lrp1b
CCAGACGCTGTGCAGCCAGT	TCCCGGTACCACTCAAAGTC	Lsamp
GGCCCGCGAACGCTTCAAGG	GCTTGGATGAGTCTAACTGC	Ltbp3
TGAGGACGAGTGCAGGCAGC	AGGAGCGTAGCACAGTCCTG	Luzp2
AGCACAGCACGGTAGTCGAG	ATTTCTAGGCAGCCAGCCAC	Maml3
ACTTGCTGGTCAATACCGAA	TGAATGATGCACCGTGCTTT	Nbas
TGCACGCTTATCTTTATCTG	TAGGTGCCCACTGATATCCA	Nkain2
GCGTTCCGGATGTCAGACCA	CATGGCGGCTCTTACATGGA	Nlgn1
GGTCCTCGAGCAGTCGCATA	CGTGGTACGACCCTTCATCC	Nrxn1
GCTGCCACAACAGACGTTCC	AGTCATGCTCAAGGGCGATT	Pacrg
CTGTCATGTCAAGGGCGCAG	AAGGTTGGTTGAGTCTGATA	Pclo
GGGCGGGCGCGCTATGACAG	GTAGTTAGTGAATCCATCTA	Plcl2
GACCCGGGCTTCGTAGGCCC	ACATCTGACTCAGACTGTGA	Qser1
GGGTTCCTGCATGACCGACC	AGCTGCGCGACTGGGAGCAA	Rbks
TCCAAGGTACAGCTCCTGCG	TGTGTCAGGCCCAATATATG	Rere
AGTGACTGCCGACTACTACA	ACATTAGTGAGACTATATTG	Rev3l
GCGGTTCAAGGGTGAAGTAG	TACTCTAGGATGCCAGCCAT	Samd5
ACTCCGCCGCCCGCCACCGA	ATTGGCTATGCACTCCAAGG	Sdk1
CTCCTGGATGTCCAGGTCCG	AAACGCACAACTCTACCCTG	Sgcz
AAACGTACAAGGAAGGCCTT	GATGAGCTGAAGGCTTCAAT	Sgip1
GACCATCTATGACACGATCC	ACAATAATGGTCGCTATCCC	Shank2
CTCATGAGGATCACCTCGTT	GACTTCGTTCAACGCTATCT	Slc25a12
GCGCTGTGCAGGCTCGGTGG	TACTCTACGAATGTCCAGAA	Slc30a9
GGAGGGTCTTAATGAAGACT	GGTCAGTGTCTCGCTGTCGT	Snrk
GCTGCGGGAATGTCGCCTGA	AAGCTCTATGACTTCAACCT	Sorcs3
TACTGACCCTGATTTACCTC	TCAGCTGATCCCAACCACTA	Sox5
ACCATAGACTATAAGAAGAA	GAGAGACAGACGCTCCAATC	Sppl3
GTCCTCCGGGTAGTACTCCG	GGATGCCAGCGAGACTGACC	Suds3
GCGAAGGAACGCCTGTCACC	GCATCACTATAAAGGATGGT	Tank
AACAGCGAATGGCTGCCTTA	TGGCGAGTCCCTGTTGTAGT	Tcf4
CATGACAGCAGAATGCACTA	GATGCAGACTCGGACACCGA	Tenm2
AGGTCCCAGACAAGGAGCGG	GCTGGCACATAGTCCTGGCT	Tox
CTCCAGCGTCTGCATCGCCC	GTGGTCAACGACACCAAGCT	Usp3
GTCCGACACCTGCGACGACC	AAGGTAAATTAGGTAATCGG	Zfp638
GTGTCCGTTGCTGAGATGCG	GAACACTATTGCCAAAGCTC	Zfp804a
TCCCTCCACCACCTCCTGCT	CTTACTCAACAGTAGCAATA	Zmynd8
CGCCTAATTTCCGGATCAAT	CGTCGCCATATGCCGGTGGC	ctrl-2
CGCTAGAAGTGGTCCAAGCC	CGTTCTGACAAATATGGTGG	ctrl-1
TTGGAGAACCACCTTGTTGG	GTGGAAAGGACGAAACACCG	ctrl-8
GAGCTGGACGGCGACGTAAA	GAGCTGGACGGCGACGTAAA	ctrl-3
GTGAATTAACCTTGAATGAG	GTGAATTAACCTTGAATGAG	ctrl-4
CCGGTTTATAAATTACGTGG	CCGGTTTATAAATTACGTGG	ctrl-5
ACCGGACTGCGATATGCCGT	ACCGGACTGCGATATGCCGT	ctrl-6
GCTCTAGGCCTATACATGGC	AGCTCTAGGCCTATACATGG	ctrl-7
